R 700 700

EA ./textures/mars1.xpm
SO ./textures/mars2.xpm
WE ./textures/mars3.xpm
NO ./textures/mars4.xpm
S ./textures/pillar.xpm

F 222,62,50
C 1,120,101



111111111111111111111111
10000002000200000000011
10000000000000N0000001
1000000000002000000111
11111111111111111111111