R 700 700

EA ./textures/floor.xpm
SO ./textures/greystone.xpm
WE ./textures/floor.xpm
NO ./textures/mossy.xpm
S ./textures/barrel.xpm

C ./textures/wood.xpm
F ./textures/colorstone.xpm
111111111111111111111111
10000002000200000000011
1000000000000000000001
1000000000002000000111
10000000000001001000111
1000000000N0010010000011
100000000000010010000001
111111111111111111111111